идти (в сторону от говорящего)|いきます [икимАс]
идти (в сторону к говорящему)|きます [кимАс]
возвращаться домой (в широком смысле)|かえります [каэримАс]
школа|がっこう [гаккОО]
супермаркет|スーパー [суупАА]
станция, вокзал|えき [экИ]
самолет|ひこうき [хикООки]
корабль|ふね [фунЭ]
поезд|でんしゃ [деншЯ]
метро|ちかてつ [чикатетсУ]
автобус|バス [басУ]
такси|タクシー [такушИИ]
велосипед|じてんしゃ [джитеншЯ]
пешком|あるいて [аруитЭ]
человек|人 [хитО]
друг|ともだち [томодачИ]
бойфренд, любовник|かれ [карЕ]
герлфренд, любовница|かの女 [каноджЁ]
семья|かぞく [казокУ]
один, одинокий|一人で [хиторидЕ]
прошлая неделя|せんしゃう [сеншЯЯ]
эта (текущая) неделя|こんしゃう [коншЯЯ]
следующая неделя|らいしゃう [райшЯЯ]
прошлый месяц|せんげつ [сенгЕцу]
этот (текущий) месяц|こんげつ [конгЕцу]
следующий месяц|らいげつ [райгЕцу]
прошлый год|きょねん [кёнЕн]
этот (текущий) год|ことし [котошИ]
следующий год|らいねん [райнЕн]
~ год|~ねん [нЕн]
какой год|なんねん [наннЕн]
месяц года (1й месяц)|~がつ [гАцу]
какой месяц|なんがつ [нангАцу]
~ дней|~にち [нИчи]
какое число, слолько дней|なんにち [наннИчи]
когда|いつ [ицУ]
день рождения|たんじょび [тандзёбИ]
да, не так ли? / да, вы правы|そですね [сОдесне]
аэропорт|くうこう [куукОО]
головной офис|ほんしゃ [хоншЯ]
номер рейса|びんめい [бинмЕй]
отправление (поезда), вылет|しゅっぱつ [шюппАтцу]
прибытие|とうちゃく [тоочЯку]
большое спасибо|どうも　ありがとう　ございました [домОО аригатОО шодзаИмашта]
не за что (ответ на 'спасибо')|どういたしまして [дойташимАшите]
