быть, находиться (об одушевленных предметах)|います [имАс]
различный|いろいろ(な) [ирОирО(на)]
мужчина|おとこのひと [отоконохитО]
женщина|おんあのひと [оннанохитО]
мальчик|おとこのこ [отоконОко]
девочка|おんあのこ [оннанОко]
собака|いぬ [инУ]
кошка|ねこ [нЕко]
панда|パンダ [пАнда]
слон|ぞう [зО:]
дерево, древесина|き [кИ]
вещь|もの [монО]
батарейка|でんち [денчИ]
коробка, ящик|はこ [хакО]
выключатель|スイッチ [суиччИ]
холодильник|れいぞうこ [рЕйзо:ко]
обеденный стол|テーブル [тЭ:буру]
кровать|ベッド [бЭддо]
полка|たな [танА]
дверь|ドア [доА]
окно|まど [мАдо]
уличный почтовый ящик|ポスト [посутО]
здание|ビル [бирУ]
банкомат|ATM [ATM]
круглосуточный магазин товаров повседневного спроса|コンビニ [конбИни]
парк|こうえん [кО:эн]
кафе|きっさてん [киссатЕн]
~ магазин|~や [~Я]
стоянка такси, остановка общественного транспорта|のりば [норибА]
префектура|けん [кЕн]
верх, вверх, наверху|うえ [уЭ]
низ, вниз, внизу|した [шитА]
перёд, вперёд, спереди|まえ [маЭ]
зад, сзади, позади|うしろ [уширО]
право, справа, направо|みぎ [мигИ]
лево, налево, слева|ひだり [хидарИ]
в, внутри|なか [нАка]
снаружи|そと [сотО]
рядом, по соседству|となり [тонарИ]
близко, окрестности|ちかく [чикакУ]
между, посреди|あいだ [айдА]
